1 1 1 1 1 1 1 1 1 1 1 1
1 7 T T T T T T T T 8 1
1 L 0 s 0 0 0 0 0 0 R 1
1 L 0 0 0 0 0 0 0 0 R 1
1 L 0 0 0 0 0 0 0 0 R 1
1 L 0 0 0 0 0 0 0 0 R 1
1 L 0 0 0 0 W G W W R 1
1 L 0 0 0 0 W 0 0 W R 1
1 L 0 0 | 0 W W F W R 1
1 L 0 0 0 0 0 W W W R 1
1 5 B B B B B B B B 6 1
1 1 1 1 1 1 1 1 1 1 1 1